JAN:
The Gloaming - S/T ****.5
Rosanne Cash - The River and the Thread ****.5
Tom Brosseau - Grass Punks ****
Thee Silver Mt. Zion Memorial Orchestra - Fuck off Get Free We Pour Light on Everything ****
Gem Club - In Roses ****
Angélique Kidjo - Eve ****
Actress - Ghettoville ***.5
Jess Williamson - Native State ***.5
VA - Killed by Deathrock: Vol. 1 ***.5
Hospitality - Trouble ***.5
The Hidden Cameras - Age ***.5
Blank Realm - Grassed Inn ***.5
Laura Cantrell - No Way From Here ***.5
Against Me! - Transgender Dysphoria Blues ***.5
The Autumn Defence - Fifth ***.5
Damien Jurado - Brothers and Sisters of the Eternal Son ***.5
VA - Sweetheart 2014 by Starbucks ***.5
The Lawrence Arms - Metropole ***
East India Youth - Total Stife Forever ***
Dum Dum Girls - Too True ***
Jeremy Jay - Abandoned ***
War Paint - War Paint - ***
Alcest - Shelter ***
Aa - VoyAger ***
Mogwai - Rave Tapes ***
Quilt - Held in Splendor ***
Sharon Jones & the Dap-Kings - Give the People What They Want **.5
Supreme Cuts - Divine Ecstasy **.5
FEB:
Wild Beasts - Present Tense *****
Beck - Morning Phase *****
Sun Kil Moon - Benji ****.5
Thumpers - Galore ****.5
Schoolboy Q - Oxymoron ****.5
Mark McGuire - Along the Way ****.5
Holly Herndon - Chorus EP ****.5
Marissa Nadler - July ****.5
St Vincent - S/T ****.5
The Notwist - Close to the Grass ****.5
CEO - Wonderland ****
Angel Olsen - Burn Your Fire for No Witness ****
Isaiah Rashad - Cilvia Demo ****
Cheetahs - Cheetahs ****
Valentin Stip - Sigh ****
Phantogram - Voices ****
Total Slacker - Slip Away ****
Bohren & Der Club of Gore - Piano Nights ****
Robert Ellis - The Light from the Chemical Plant ****
Jeremy Messersmith - Heart Murrmurs ****
Jerome LOL - Deleted/Fool EP ****
Eric Church - The Outsiders ***.5
Lydia Loveless - Somewhere Else ***.5
Container - Adhesive ***.5
Untold - Black Light Spiral ***.5
Speedy Ortiz - Real Hair EP ***.5
Cibo Matto - Hotel Valentine ***.5
Hurray for the Riff Raff - Small Town Heroes ***.5
Young Fathers - Dead ***.5
Neneh Cherry - Blank Project ***.5
Tinariwen - Emmaar ***.5
Lost in the Trees - Past Life ***.5
Bleeding Rainbow - Interrupt ***
Modern Baseball - You're Gonna Miss It All ***
Thug Entrancer - Death After Life ***
Acid Arab - Collection LP ***
The Haden Triplets - S/T ***
Death Vessel - Island Intervals ***
St. Paul and the Broken Bones - Half the City ***
Behemoth - The Satanist ***
Gina Chavez - Up.Rooted ***
Yautja - Songs of Descent ***
Katy B - Little Red ***
Magic Touch - Palermo House Gang ***
††† - ††† **.5
Temples - Sun Structures **.5
Mozes and the Firstborn - S/T **.5
Vertical Scratchers - Daughter of Everything **.5
Bayside - Cult **.5
The Hotelier - Home, Like Noplace is There ****
MAR:
Perfect Pussy - Say Yes to Love ****.5
Raz Simone - Cognitive Dissonance ****.5
Frankie Cosmos - Zentropy ****
Future Islands - Singles ****
Sisyphus (Sufjan Stevens, Son Lux, Serengeti) - S/T ****
Freddie Gibbs and Madlib - Pinata ****
Yasmine Hamdan - Ya Nass ****
Rick Ross - Mastermind ****
Gang Wizard - Important Picnic ****
Real Estate - Atlas ****
Ambrose Akinmusire - the imagined savior is far easier to paint ****
Tycho - Awake ****
Chimurenga Renaissane - riZe vadZimu riZe ****
Posse - Soft Opening ****
Linda Perhacs - The Soul of All Natural Things ****
Augustin Hadelich - Sibelius, Adès: Violin Concertos ****
Diane Cluck - Boneset ****
Trust - Joyland ****
The War on Drugs - Lost In the Dream ****
Kevin Drew - Darlings ***.5
YG - My Krazy Life ***.5
Elbow - The Take Off and Landing of Everything ***.5
Liars - Mess ***.5
Step Brothers - Lord Steppington ***.5
La Dispute - Rooms of the House ***.5
Cult & Leper - Twin Knobs Power City ***.5
Bryce Dessner / Jonny Greenwood - St. Carolyn by the Sea / Suite from "There Will Be Blood" ***.5
Alexandre Desplat / Randall Poster - The Grand Budapest Hotel OST ***.5
Carla Bozulich - Boy ***.5
Ana Tijoux - Vengo ***.5
Bradford Cox - Teenage ***.5
Mac Cooper - Human ***.5
Eagulls - Eagulls ***.5
Legowelt - Crystal Cult 2080 ***.5
The Range - Panasonic EP ***
The Unseemable - S/T ***
Thou - Heathen ***
Calle 13 - Multi_Viral ***
Nothing - Guilty of Everything ***
Sara Evans - Slow Me Down ***
Black Lips - Underneath the Rainbow ***
The Men - Tomorrow's Hits ***
DJ Q - Ineffable ***
Indian - From All Purity ***
Morning Glory - War Psalms ***
Johnny Foreigner - You Can Do Better **.5
Murmur - S/T **.5
APR:
Todd Terje - It's Album Time *****
Wye Oak - Shriek ****.5
Saintseneca - Dark Arc ****.5
The Body - I Shall Die Here ****.5
Jesse Boykins III - Love Apparatus ****.5
Brody Dalle - Diploid Love ****.5
Mac DeMarco - Salad Days ****
S. Carey - Range of Light ****
Ratking - So It Goes ****
Future - Honest ****
Deleted Scenes - Lithium Burn ****
Ingrid Michaelson - Lights Out ****
Damon Albarn - Everyday Robots ****
Teebs - E S T A R A ****
Tweens - Tweens ****
Fear of Men - Loom ****
Ben Watt - Hendra ****
Ought - More Than Any Other Day ***.5
Jackie McDowell - Baptisia
Clout Cult - Unplug ***.5
Lockah - Yahoo or the Highway ***.5
Timber Timbre - Hot Dreams ***.5
Cloud Nothings - Here and Nowhere Else ***.5
EMA - The Future's Void ***.5
Woods - With Light and With Love ***.5
Jeremiah Jae - Good Times ***.5
Protomartyr - Under Color of Offical Right ***.5
Valentine Lisitsa - Chasing Pianos ***.5
OFF! - Wasted Years ***
Rodney Crowell - Tarpaper Sky ***
The Ministry of Wolves - Music from Republik der Wölfe ***
The Both - S/T ***
Kessica Lea Mayfield - Make My Head Sing... ***
Nickel Creek - A Dotted Line ***
Rodrigo y Gabriela - 9 Dead Alive ***
Pyrrhon - The Mother of Virtues ***
Amps for Christ - Canyons Cars and Crows ***
Ghetto Gouls - S/T ***
Pup - Pup ***
Thievery Corporation - Saudade **.5
Odonis Odonis - Hard Boiled Softboiled **.5
Plague Vendor - Free to Eat **.5
MAY:
Ben Frost - A U R O R A ****.5
Sharon Van Etten - Are We There ****.5
Sean Nicholas Savage - Bermuda Waterfall ****.5
Fennesz - Bécs ****.5
tUnE-yArDs - Nikki Nack ****
Hundred Waters - The Moon Rang Like a Bell ****
Owen Pallett - In Conflict ****
Toumani Diabaté - Toumani & Sidiki ****
Lykke Li - I Never Learn ****
Swans - To Be Kind ****
Bo Ningen - III ****
Lee Fields - Emma Jean ***.5
Sylvan Esso - S/T ***.5
Dolly Parton - Blue Smoke ***.5
Mirah - Changing Light ***.5
Nikki Lane - All Or Nothin' ***.5
Seun Kuti & Egypt 80 - A Long Way to the Beginning ***.5
Douglas Dare - Whelm ***
Jolie Holland - Wine Dark Sea ***
Sturgill Simpson - Metamodern Sounds in Country Music ***
Wovenhand - Refactory Obdurate ***
Pacifika - Amor Planeta ***
Lee Bains III & the Glory Fires - Dereconstructed **.5
JUNE:
How to Dress Well - What is This Heart? *****
A Sunny Day in Glasgow - Sea When Absent ****.5
White Lung - Deep Fantasy ****
Lone - Reality Testing ****
Total Control - Typical System ****
Phox - Phox ****
Hamilton Leithauser - Black Hours ****
Open Mike Eagle - Dark Comedy ****
Parquet Courts - Sunbathing Animal ****
Willie Nelson - Band of Brothers ****
The Antlers - Familiars ****
Naked Island - Naked Island ***.5
The Phantom Band - Strange Friend ***.5
Popcaan - Where We Come From ***.5
Circulatory Systems - Mosaics Within Mosaics ***.5
CLPPNG - CLPPNG ***.5
The Soft Pink Truth - Why Do the Heathen Rage? ***.5
First Aid Kit - Stay Gold ***.5
Boris - Noise ***
Jose James - While You Were Sleeping ***
Lana Del Rey- Ultraviolence **.5
Tombs - Savage Gold **.5
JULY:
Little Daylight - Hello Memory *****
Makthavarskan - II *****
Shabazz Palaces - Lese Majesty ****
DJ Dodger Stadium - Friend of Mine ****
Alvvays - Alvvways ****
Alex G - DSU ****
Jenny Lewis - The Voyager ****
Leon Vynehall - Music for the Univited ****
Shamir - Northtown EP ****
Luluc - Passerby ***.5
Amen Dunes - Love ***.5
Trampled by Turtles - Wild Animals ***
Joyce Manor - Never Hungover Again ***
Wildest Dreams - S/T **.5
Tom Petty and the Heartbreakers - Hypnotic Eye **
AUG:
Porter Robinson - Worlds ****.5
Ariana Grande - My Everything ****.5
FKA Twigs - LP1 ****.5
Merchandise - After the End *****.5
Spoon - They Want My Soul ****.5
Susanna / Jenny Hval - Meshes of Voice ****.5
Adult Jazz - Gist Is ****.5
Mirel Wagner - When the Cellar Children See the Light of Day ****
Twin Peaks - Wild Onion ****
The New Pornoraphers - Brill Bruisers ****
Cymbals Eat Guitars - Lose ****
Ty Segall - Manipulator ***.5
JJ -V ***.5
Bishop Allen - Lights Out ***.5
Orenda Fink - Blue Dream ***.5
Mozart's Sister - Being ***.5
Bear in Heaven - Time is Over One Day Old ***.5
J. Mascis - Tied to a Star ***.5
Spider Bags - Frozen Letter ***.5
Sarah Jaffe - Don't Disconnect ***.5
Pallbearer - Foundations of Burden ***
Shovel & Rope - Swimmin' Time ***
The Underachievers - Cellar Door: Terminus Ut Exordium ***
Christopher Denny - If the Roses Don't Kill Us ***
Panopticon - Roads to the North ***
The Wytches - Annabel Dream Reader **.5
SEP:
Mr. Twin Sister - S/T *****
Jens Lekman - WWJD Mixtape *****
Aphex Twin - Syro ****.5
Electric Youth - Innerworld ****.5
Aby Ngana Diop - Liital ****.5 (re-release, but good luck finding a copy of this before now)
Perfume Genius - Too Bright ****
Gerard Way - Hesitant Alien ****
John Luther Adams - Become Ocean ****
Kat Edmonson - The Big Picture ***.5
Interpol - El Pintor ***.5
YOB - Clearning the Path to Ascend ***.5
Electric Wizard - Time to Die ***
Sinkane - Mean Love ***
Zammuto - Anchor ***
Leonard Cohen - Popular Problems ***
Tweedy - Sukierae ***
GOAT - Commune **
OCT:
The Weather Station - What Am I Going to Do With Everything I Know *****
Objekt - Flatland *****
Run the Jewels - RTJ2 *****
Flying Lotus - You're Dead! *****
Vince Staples - Hell Can Wait EP *****
Grouper - Ruins *****
Jessie Ware - Tough Love ****.5
Kindness - Otherness ****.5
Pharmakon - Bestial Burden ****.5
Iceage - Plowing Into the Field of Love ****
DJ Quik - The Midnight Life ****
Kevin Drumm - Trouble****
Caribou - Our Love ****
Scott Walker - Soused ****
Steve Gunn - Way Out Weather ****
Stars - No One is Lost ***.5
Meatbodies - Meatbodies ***.5
Ex Hex - Rips ***
Ben Howard - I Forget Where We Were ***
Godflesh - A World Lit Only By Fire ***
We Were Promised Jetpacks - Unravelling ***
Frazey Ford - Indian Ocean ***
NOV:
Azealia Banks - Broke with Expensive Taste *****
Les Sins - Michael ****.5
Andy Scott - Faith in Strangers ****.5
Clark - Clark ****.5
Ariel Pink - Pom Pom ****.5
Loscil - Sea Island ****.5
Dirty Beaches - Stateless ****.5
Deerhoof - La Isla Bonita ****
Torn Hawk - Let's Cry and Do Pushups at the Same Time ****
Cult of Youth - Final Days ****
Arca - Xen ****
Hookworms - The Hum ***.5
Mr. Gnome - The Heart of a Dark Star ***.5
Brian Ferry - Avonmore **.5
Thompson - Family **.5
Dec:
D'Angelo - Black Messiah *****
Charli XCX - Sucker ****.5
Ben Frost - V A R I A N T [EP] ****.5
Ghostface Killah - 36 Seasons ****
James Blake - 200 Press EP ****
Juju & Jordash - Clean-Cut ****
Owen - Other People's Songs ***.5
Raspberry Bulbs - Privacy ***.5
The Jacka - What Happened to the World ***.5
Old Man Gloom - The Ape of God **.5
Smashing Pumpkins - Monuments to an Elegy **
Missed:
Lydia Ainsworth - Right from Real *****
TOPS - Picture You Staring *****
Recycle Culture - Drown Me Up *****
You'll Never Get to Heaven - Adorn *****
Highasakite - Silent Treatment ****.5
Nils Frahm - Spaces ****.5
Gazelle Twin - UNFLESH ****.5
Curtis Harding - Soul Power ****.5
Teyana Taylor - VII ****.5
Girlpool - Girlpool EP ****.5
Vince Staples - Shyne Coldchain Vol. 2 ****.5
Ana Caprix - For Seven Nights This Island is Ours ****.5
Doss - Doss + remixes ****.5
Korallreven - Death is Not For Us ****.5
Damien Rice - My Favorite Faded Fantasy ****.5
Tinashe - Aquarius ****.5
Taylor McFerrin - Early Riser ****.5
Vessel - Punish, Honey ****.5
Vesuvio Solo - Favors ****.5
Sales - Sales EP ****.5
Leon Fleisher - All The Things You Are ****.5
One Direction - Four ****
Moodyman - Moodyman ****
Yumi Zouma - Yumi Zouma EP ****
Strand of Oaks - HEAL ****
Beverly - Careers ****
Ryan Adams - Ryan Adams ****
Haley Bonar - Last War ****
Mica Levi - Under the Skin Soundtrack ****
Mark Baroott - Sketches From An Island ****
Mary J. Blige - The London Sessions ****
Miranda Lambert - Platinum ****
Kiasmos - Kiasmos ****
M. Geddes Gengras - Ishi ****
Béla Fleck & Abigail Washburn - Béla Fleck & Abigail Washburn ****
Chet Faker - Built on Glass ****
Weyes Blood - The Innocents ****
Pvris - White Noise ****
Naomi Bedford - A History of Insolence ****
Triptykon - Melan Chasmata ****
A Winged Victory for the Sullen - Atomos ****
Joyce Didonato - Stella di Napoli ****
Prague Radio Symphony Orchestra/Prague Philharmonic Choir - Leoš Janáček, Glagolitic Mass ****
Justin Townes Earle - Single Mothers ****
Chumped - Teenage Retirement ****
Taylor Swift - 1989 ***.5
Asgeir - In the Silence ***.5
Mimicking Birds - Eons ***.5
The Duhks - Beyond the Blue ***.5
The Bug - Angels and Devils ***.5
Noura Mint Seymali - Tzenni ***.5
Panda Bear - Mr. Noah EP ***.5
T.I. - Paperwork ***.5
Kassem Mosse - Workshop 19 ***.5
Allah-Las - Worship the Sun ***.5
Courtney Barnett - The Double EP: A Sea of Split Peas ***.5
Jason Moran - All Rise: A Joyful Elegy for Fats Waller ***.5
Mitski - Bury Me at Makeout Creek ***.5
Viet Cong - Cassette ***.5
The Family Crest - Beneath the Brine ***
King Tuff - Black Moon Spell ***
Hail Mary Mallon - Bestiary ***
Ages and Ages - Divisionary ***
Jeff Ballard - Time's Tales ***
Horrendous - Ecdysis ***
Bellows - Blue Breath ***
Drive-By Truckers - English Ocean ***
Nux Vomica - Nux Vomica ***
Angaleena Preseley - American Middle Class ***
Chris Staples - American Soft ***
Stromae - Racine Carée ***
Brian Eno / Karl Hyde - High Life ***
Migos - Rich Nigga Timeline ***
Ceci Bastida - En La Edad De La Violencia ***
Hiss Golden Messenger - Lateness of Dancers **.5
Rodrigo Amarante - Cavalo **.5
John Southworth - Niagara **.5
Jorge Drexler - Bailar En La Cuerva **.5
From Indian Lakes - Absent Sounds **.5
Homeboy Sandman - Hallways **.5
Hozier - Hozier **.5
Young Thug & Bloody Jay - Black Portland **.5
Alt-J - This is All Yours **.5
Dom Flemons - Prospect Hill **
You Blew It! - Keep Doing What You're Doing **
The Marmozets - The Weird and Wonderful **
Reigning Sound - Shattered **
Parker Millsap - Parker Millsap **
The Ghost Inside - Dear Youth **
Weezer - Everything Will Be Alright in the End *.5
Every Time I Die - From Parts Unknown *.5
Dads - I'll Be the Tornado *.5
LVL Up - Hoodwink'd *.5
Shakey Graves - And the War Came *.5
Jack White - Lazaretto *.5
Sam Hunt - Montevallo *.5
Martha - Courting Strong *
Hostage Calm - Die on Stage *
Brownout - Presents Brown Sabbath .5

Songs:
Charlie XCX - Boom Clap
Oneohtrix Point Never - Rush
Miguel - nwa [ft. Kurupt]
Nicki Minaj - Feeling Myself [ft. Beyoncé]
Panda Bear - Boys Latin
D'Angelo - Sugah Daddy
Lady Lamb the Beekeeper - Billions of Eyes
Jefre Cantu-Ledesma - Pale Flower
Petite Noir - Chess
Soft Moon - Black
Krill - Torturer
Anthony Naples - Refugio
DJ Slugo - Ghetto
Delroy Edwards - Can U Get With

Mobb Deep - The Infamous (1995)
Bikini Kill - Yeah Yeah Yeah Yeah (1993)
Purling Hiss ST (2009)
Life Without Buildings - Any Other City (2001)
David Lynch - The Air is on Fire (2007)
Songs: Ohia - Journey On: Collected Singles (2014)
Grace Jones - Nightclubbing (1981)
Creation Rebel / New Age Steppers - Threat to Creation (1981)
Lewis - L'amour (1983)
Lewis - Romantic Times (1985)
American Football - S/T (1999)
DJ Sprinkles - Midtown 120 Blues (2009)
C86 (1986)
Coachwhips - Get Yer Body Next Ta Mine
M83 - Dead Cities, Red Seas & Lost Ghosts (2003)
M83 - Before the Dawn Heals Us (2005)
Underworld - Dubnobasswithmyheadman
Jawbreaker - 24 Hour Revenge Therapy (1994)
Brian Eno / Jon Hassell - Fourth World Vol. 1: Possible Musics
William Onyeabor - Box Set

Five Stars of 2014:
Porter Robinson - Worlds
Todd Terje - It's Album Time
D'Angelo and the Vanguard - Black Messiah
Little Daylight - Hello Memory
Run the Jewels - 2
Wild Beasts - Present Tense
Mr. Twin Sister - S/T
TOPS - Picture You Staring
Ben Frost - A U R O R A
Azaelia Banks - Broke with Expensive Taste

Makthavarskan - II
Flying Lotus - You're Dead!
Beck - Morning Phase
The Weather Station - What Am I Going to Do With Everything I Know *****
How to Dress Well - What Is This Heart?


Favorite Songs of 2014:
Raz Simone - They'll Speak
Miguel - Bennie and the Jets (ft. Wale)
Jenny Lewis - She's Not Me
Alvvays - Archie, Marry Me
Charli XCX - Boom Clap
Future Islands - Seasons (Waiting On You)
Portable - Surrender
Kevin Drew - Good Sex
Ariana Grande - Problem
Fear of Men - Descent


Older Albums:
Tony Molina - Dissed and Dismissed (2013) *****
Perfect Pussy - I Have Lost All Desire for Feeling (2013) *****
Sun Ra and His Arkestra - In the Orbit of Ra (2014) *****
Max Richter - Memoryhouse ***** (2009)
A Certain Ratio - Sextet (1982) ****.5
Brigitte Fontaine - Comme a la Radio (1969) ****.5
Lavender Country - S/T (1973) ****.5
Bjork - Drawing Restraint #9 (2010) ****
Brian Eno - Nerve Net (1992) ****
Wyrd Visions - Half-Eaten Guitar ****
Offenders - Endless Struggle (1985) ***.5
Peter Walker - "Second Poem to Karmela" or Gypsies Are Important (1968) ***.5
Death - Death III ***


Ideas:
Beatbox animation based on my own beatbox
Music video based on one of my songs

Movies:
Stranger by the Lake
Visitors
The Long Day Closes
Breaking the Waves